Isabelly Pereira - Plocun
Samuel Rocha - Nupios
Pedro Miguel Barbosa - Siwayr
Ana Cardoso - Losala
Sr. Luiz Gustavo das Neves - Gierae
Murilo Vieira - Alhoes
Maria Cec√≠lia Cavalcanti - Rawiwu
Fernando Mendes - Biahay
Beatriz Lopes - Voazur
Dr. Leandro Melo - Olfara
Pedro Miguel Souza - Duywus
Sarah Caldeira - Robica
Diogo Moura - Ciorer
Emanuel Correia - Niedio
Raul Fernandes - Lezoli
J√∫lia Azevedo - Wozeus
Vicente Porto - Ussiun
Isabella Almeida - Wugaer
Ester Duarte - Pauswo
Davi Sales - Blecol
Luiz Felipe Silva - Leguis
Isabel Rocha - Diarar
Marcelo da Rosa - Irdour
Mait√™ Cardoso - Mehosu
Sr. Vit√≥ria Cardoso - Loyliu
Gabriela da Cruz - Viseur
Eduardo da Mota - Nyolun
Louren√ßo Azevedo - Zafuol
Maria Cec√≠lia Campos - Basues
Dra. Sofia Moura - Fixear
Rafael Moreira - Cyudol
Sr. Bruno da Mata - Caohol
Jo√£o Felipe Jesus - Fofeas
Ana Vit√≥ria Gon√ßalves - Hyubiu
Daniel Moura - Fitimu
Al√≠cia Ribeiro - Muaril
Calebe Moraes - Cohome
Sabrina Melo - Orheku
Sr. Ryan Cunha - Zarufo
Srta. √?sis Silveira - Fezaen
Luiz Miguel Pires - Gouhue
Raquel Teixeira - Cuwuor
Brenda Moura - Canies
Enzo Martins - Keawea
Mariana Vieira - Gihuho
Sr. Maria Alice Pereira - Fyodin
Giovanna Cavalcanti - Zaunre
Sr. Ben√≠cio Moreira - Zaedal
Srta. Maria Vit√≥ria Barbosa - Hopein
Artur Correia - Helial
Levi Lima - Sesacu
Melissa Viana - Faobos
Lucca Campos - Seozes
Luiz Gustavo Farias - Barual
Mait√™ Silva - Geregu
Sr. Thales Almeida - Nimblelitz
Igor Moraes - Nuxate
Miguel Barbosa - Wuybie
Fernanda Moreira - Ernuin
Gabriela Nascimento - Xizoen
L√≠via Jesus - Onnemu
Ana Carolina Monteiro - Zasios
Fernanda Castro - Hoirua
Beatriz Nogueira - Suaesl
Ana Vit√≥ria Azevedo - Laoxyu
Jo√£o Vitor Duarte - Quevur
Marina Correia - Hotavu
Jo√£o Miguel Alves - Leazor
Lucca da Mota - Duauns
Sr. Rafael Nascimento - Niawar
Cec√≠lia Oliveira - Xueusr
Alexia Foga√ßa - Muadia
Raul Moraes - Vaowos
Ana Vit√≥ria Pinto - Futain
Clara Barbosa - Tuzous
Melissa da Luz - Zioann
Dr. Renan Oliveira - Hopyol
Maria Fernanda Rezende - Petaur
Gabrielly Foga√ßa - Tagutu
Ana Clara Ferreira - Diwuer
Ana Vit√≥ria Fernandes - Zaepeo
Ir. Lucca Lopes - Mulapa
Ana Luiza Viana - Vulove
Dr. Diogo Rezende - Tozeur
Sr. Alexandre Sales - Gadabi
Bruna Peixoto - Gyuasl
Bryan Vieira - Uswyer
Sr. Calebe Vieira - Maleal
Nathan da Rocha - Dauboy
Luna Santos - Lekoyr
Juliana Azevedo - Keywur
Elisa Duarte - Orwael
Emanuela da Rocha - Caypul
Sr. Stella Moura - Payman
Sr. Juan da Paz - Leualr
Pedro Ribeiro - Cituis
Dra. Ana Sofia Barros - Nedubu
Matheus Ferreira - Nagaus
Levi Novaes - Ertoil
Thales Dias - Piaxel
